{
    "0": "문화",
    "1": "스포츠",
    "2": "정치",
    "3": "사회",
    "4": "기술",
    "5": "경제",
    "6": "국제"
}